//MAP CONVERTED BY dmm2tgm.py THIS HEADER COMMENT PREVENTS RECONVERSION, DO NOT REMOVE
"a" = (
/turf/template_noop,
/area/template_noop)
"b" = (
/turf/closed/wall/mineral/titanium,
/area/shuttle/arrival)
"c" = (
/obj/structure/fans/tiny,
/obj/machinery/door/airlock/shuttle{
	name = "Arrival Shuttle Airlock"
	},
/obj/effect/turf_decal/siding/dark{
	dir = 1
	},
/obj/effect/turf_decal/siding/dark,
/turf/open/floor/iron/dark/textured_large,
/area/shuttle/arrival)
"d" = (
/obj/effect/spawner/structure/window/reinforced/shuttle,
/obj/structure/fans/tiny/invisible,
/turf/open/floor/plating,
/area/shuttle/arrival)
"f" = (
/obj/effect/turf_decal/trimline/neutral/mid_joiner,
/obj/effect/turf_decal/trimline/neutral/mid_joiner{
	dir = 8
	},
/obj/effect/turf_decal/trimline/neutral/filled/corner{
	dir = 4
	},
/obj/effect/turf_decal/trimline/neutral/filled/warning{
	dir = 10
	},
/turf/open/floor/iron/corner{
	dir = 4
	},
/area/shuttle/arrival)
"g" = (
/obj/structure/chair/comfy/shuttle{
	dir = 1
	},
/obj/effect/turf_decal/siding/dark{
	dir = 5
	},
/obj/effect/turf_decal/trimline/neutral/filled/line{
	dir = 5
	},
/obj/effect/turf_decal/trimline/neutral/filled/mid_joiner{
	dir = 1
	},
/obj/effect/turf_decal/trimline/neutral/filled/mid_joiner{
	dir = 4
	},
/turf/open/floor/iron/dark/smooth_large,
/area/shuttle/arrival)
"h" = (
/obj/effect/turf_decal/trimline/neutral/filled/line,
/obj/effect/turf_decal/trimline/neutral/filled/line{
	dir = 1
	},
/obj/effect/turf_decal/trimline/neutral/filled/mid_joiner{
	dir = 1
	},
/turf/open/floor/iron/edge{
	dir = 1
	},
/area/shuttle/arrival)
"k" = (
/obj/machinery/power/shuttle_engine/heater{
	dir = 4
	},
/obj/structure/window/reinforced/survival_pod/spawner/directional/west,
/turf/open/floor/iron/dark/textured_large/airless,
/area/shuttle/arrival)
"l" = (
/obj/machinery/power/shuttle_engine/propulsion/burst/right{
	dir = 4
	},
/turf/open/floor/iron/dark/textured_large/airless,
/area/shuttle/arrival)
"m" = (
/obj/effect/spawner/structure/window/reinforced/shuttle,
/obj/structure/fans/tiny/invisible,
/obj/machinery/door/poddoor/shutters/preopen{
	id = "arrivy";
	name = "Ship Shutters";
	dir = 8
	},
/turf/open/floor/plating,
/area/shuttle/arrival)
"n" = (
/obj/machinery/button/door/directional/south{
	id = "arrivy";
	name = "Ship Shutters Control";
	pixel_x = 25;
	pixel_y = -25
	},
/obj/effect/turf_decal/trimline/neutral/filled/mid_joiner{
	dir = 4
	},
/obj/effect/turf_decal/trimline/neutral/filled/line{
	dir = 6
	},
/obj/effect/turf_decal/trimline/neutral/filled/mid_joiner,
/turf/open/floor/iron/dark/smooth_corner{
	dir = 1
	},
/area/shuttle/arrival)
"o" = (
/obj/effect/turf_decal/trimline/neutral/filled/line{
	dir = 4
	},
/obj/effect/turf_decal/trimline/neutral/filled/warning{
	dir = 8
	},
/turf/open/floor/iron/edge{
	dir = 8
	},
/area/shuttle/arrival)
"p" = (
/obj/machinery/power/shuttle_engine/propulsion{
	dir = 4
	},
/obj/docking_port/mobile/arrivals{
	name = "pubby arrivals shuttle"
	},
/turf/open/floor/iron/dark/textured_large/airless,
/area/shuttle/arrival)
"q" = (
/obj/structure/chair/comfy/shuttle{
	dir = 4
	},
/obj/effect/turf_decal/trimline/neutral/filled/line{
	dir = 10
	},
/obj/effect/turf_decal/trimline/neutral/filled/mid_joiner,
/obj/effect/turf_decal/trimline/neutral/filled/mid_joiner{
	dir = 8
	},
/turf/open/floor/iron/dark/smooth_corner{
	dir = 4
	},
/area/shuttle/arrival)
"r" = (
/obj/machinery/power/shuttle_engine/propulsion{
	dir = 4
	},
/turf/open/floor/iron/dark/textured_large/airless,
/area/shuttle/arrival)
"u" = (
/obj/machinery/light/directional/south,
/obj/item/radio/intercom/directional/south,
/obj/effect/turf_decal/trimline/neutral/filled/line{
	dir = 1
	},
/obj/effect/turf_decal/trimline/neutral/filled/line,
/obj/effect/turf_decal/trimline/neutral/filled/mid_joiner,
/turf/open/floor/iron/edge,
/area/shuttle/arrival)
"v" = (
/obj/machinery/power/shuttle_engine/propulsion/burst/left{
	dir = 4
	},
/turf/open/floor/iron/dark/textured_large/airless,
/area/shuttle/arrival)
"w" = (
/obj/structure/closet/emcloset,
/obj/item/storage/medkit/o2,
/obj/item/tank/internals/emergency_oxygen,
/obj/item/clothing/mask/breath,
/obj/effect/turf_decal/siding/dark,
/obj/machinery/light/small/directional/north,
/obj/effect/turf_decal/trimline/neutral/filled/mid_joiner,
/obj/effect/turf_decal/trimline/neutral/filled/line,
/turf/open/floor/iron/dark,
/area/shuttle/arrival)
"x" = (
/obj/machinery/light/directional/south,
/obj/structure/extinguisher_cabinet/directional/south,
/obj/effect/turf_decal/trimline/neutral/filled/line{
	dir = 1
	},
/obj/effect/turf_decal/trimline/neutral/filled/line,
/obj/effect/turf_decal/trimline/neutral/filled/mid_joiner,
/turf/open/floor/iron/edge,
/area/shuttle/arrival)
"z" = (
/obj/effect/turf_decal/trimline/neutral/mid_joiner{
	dir = 1
	},
/obj/effect/turf_decal/trimline/neutral/mid_joiner{
	dir = 4
	},
/obj/effect/turf_decal/trimline/neutral/filled/corner{
	dir = 8
	},
/obj/effect/turf_decal/trimline/neutral/filled/warning{
	dir = 5
	},
/turf/open/floor/iron/corner{
	dir = 8
	},
/area/shuttle/arrival)
"B" = (
/obj/structure/chair/comfy/shuttle,
/obj/effect/turf_decal/siding/dark,
/obj/effect/turf_decal/trimline/neutral/filled/line,
/obj/effect/turf_decal/trimline/neutral/filled/mid_joiner,
/turf/open/floor/iron/dark/smooth_large,
/area/shuttle/arrival)
"C" = (
/obj/machinery/door/airlock/titanium{
	name = "Arrivals Shuttle Airlock";
	id_tag = "arrivy2"
	},
/obj/effect/turf_decal/siding/dark{
	dir = 4
	},
/obj/effect/turf_decal/siding/dark{
	dir = 8
	},
/turf/open/floor/iron/dark/textured_large,
/area/shuttle/arrival)
"E" = (
/obj/structure/chair/comfy/shuttle{
	dir = 4
	},
/obj/effect/turf_decal/trimline/neutral/filled/line{
	dir = 9
	},
/obj/effect/turf_decal/trimline/neutral/filled/mid_joiner{
	dir = 8
	},
/obj/effect/turf_decal/trimline/neutral/filled/mid_joiner{
	dir = 1
	},
/turf/open/floor/iron/dark/smooth_corner,
/area/shuttle/arrival)
"F" = (
/obj/effect/turf_decal/trimline/neutral/mid_joiner,
/obj/effect/turf_decal/trimline/neutral/mid_joiner{
	dir = 4
	},
/obj/effect/turf_decal/trimline/neutral/filled/corner{
	dir = 1
	},
/obj/effect/turf_decal/trimline/neutral/filled/warning{
	dir = 6
	},
/turf/open/floor/iron/corner{
	dir = 1
	},
/area/shuttle/arrival)
"G" = (
/obj/effect/turf_decal/siding/dark,
/obj/effect/turf_decal/trimline/neutral/filled/line,
/turf/closed/wall/mineral/titanium,
/area/shuttle/arrival)
"H" = (
/obj/effect/turf_decal/trimline/neutral/filled/line{
	dir = 8
	},
/obj/effect/turf_decal/trimline/neutral/filled/line{
	dir = 4
	},
/obj/effect/turf_decal/trimline/neutral/filled/mid_joiner{
	dir = 4
	},
/turf/open/floor/iron/edge{
	dir = 4
	},
/area/shuttle/arrival)
"I" = (
/obj/effect/turf_decal/trimline/neutral/filled/mid_joiner{
	dir = 4
	},
/obj/effect/turf_decal/trimline/neutral/filled/line{
	dir = 5
	},
/obj/effect/turf_decal/trimline/neutral/filled/mid_joiner{
	dir = 1
	},
/turf/open/floor/iron/dark/smooth_corner{
	dir = 8
	},
/area/shuttle/arrival)
"J" = (
/obj/effect/turf_decal/siding/dark{
	dir = 1
	},
/obj/effect/turf_decal/trimline/neutral/filled/line{
	dir = 1
	},
/turf/closed/wall/mineral/titanium,
/area/shuttle/arrival)
"K" = (
/obj/structure/chair/comfy/shuttle{
	dir = 1
	},
/obj/effect/turf_decal/siding/dark{
	dir = 9
	},
/obj/effect/turf_decal/trimline/neutral/filled/line{
	dir = 9
	},
/obj/effect/turf_decal/trimline/neutral/filled/mid_joiner{
	dir = 1
	},
/obj/effect/turf_decal/trimline/neutral/filled/mid_joiner{
	dir = 8
	},
/turf/open/floor/iron/dark/smooth_large,
/area/shuttle/arrival)
"N" = (
/obj/effect/turf_decal/trimline/neutral/filled/line{
	dir = 1
	},
/obj/effect/turf_decal/trimline/neutral/filled/line,
/obj/effect/turf_decal/trimline/neutral/filled/mid_joiner,
/turf/open/floor/iron/edge,
/area/shuttle/arrival)
"O" = (
/obj/structure/table,
/obj/item/storage/medkit/regular{
	pixel_y = 4
	},
/obj/item/storage/toolbox/emergency,
/obj/effect/turf_decal/siding/dark{
	dir = 1
	},
/obj/machinery/light/small/directional/south,
/obj/effect/turf_decal/trimline/neutral/filled/mid_joiner{
	dir = 1
	},
/obj/effect/turf_decal/trimline/neutral/filled/line{
	dir = 1
	},
/turf/open/floor/iron/dark,
/area/shuttle/arrival)
"P" = (
/obj/machinery/light/directional/north,
/obj/machinery/requests_console/directional/north{
	department = "Arrivals shuttle";
	name = "Arrival Shuttle Requests Console"
	},
/obj/effect/turf_decal/trimline/neutral/filled/line,
/obj/effect/turf_decal/trimline/neutral/filled/line{
	dir = 1
	},
/obj/effect/turf_decal/trimline/neutral/filled/mid_joiner{
	dir = 1
	},
/turf/open/floor/iron/edge{
	dir = 1
	},
/area/shuttle/arrival)
"R" = (
/obj/structure/chair/comfy/shuttle,
/obj/effect/turf_decal/siding/dark{
	dir = 6
	},
/obj/effect/turf_decal/trimline/neutral/filled/line{
	dir = 6
	},
/obj/effect/turf_decal/trimline/neutral/filled/mid_joiner,
/obj/effect/turf_decal/trimline/neutral/filled/mid_joiner{
	dir = 4
	},
/turf/open/floor/iron/dark/smooth_large,
/area/shuttle/arrival)
"U" = (
/obj/structure/fans/tiny,
/obj/machinery/door/airlock/shuttle{
	name = "Arrival Shuttle Airlock"
	},
/obj/effect/turf_decal/siding/dark,
/obj/effect/turf_decal/siding/dark{
	dir = 1
	},
/turf/open/floor/iron/dark/textured_large,
/area/shuttle/arrival)
"V" = (
/obj/structure/chair/comfy/shuttle,
/obj/effect/turf_decal/siding/dark{
	dir = 10
	},
/obj/effect/turf_decal/trimline/neutral/filled/line{
	dir = 10
	},
/obj/effect/turf_decal/trimline/neutral/filled/mid_joiner,
/obj/effect/turf_decal/trimline/neutral/filled/mid_joiner{
	dir = 8
	},
/turf/open/floor/iron/dark/smooth_large,
/area/shuttle/arrival)
"X" = (
/obj/effect/turf_decal/trimline/neutral/mid_joiner{
	dir = 1
	},
/obj/effect/turf_decal/trimline/neutral/mid_joiner{
	dir = 8
	},
/obj/effect/turf_decal/trimline/neutral/filled/corner,
/obj/effect/turf_decal/trimline/neutral/filled/warning{
	dir = 9
	},
/turf/open/floor/iron/corner,
/area/shuttle/arrival)
"Y" = (
/obj/machinery/light/directional/north,
/obj/machinery/newscaster/directional/north,
/obj/effect/turf_decal/trimline/neutral/filled/line,
/obj/effect/turf_decal/trimline/neutral/filled/line{
	dir = 1
	},
/obj/effect/turf_decal/trimline/neutral/filled/mid_joiner{
	dir = 1
	},
/turf/open/floor/iron/edge{
	dir = 1
	},
/area/shuttle/arrival)
"Z" = (
/obj/structure/chair/comfy/shuttle{
	dir = 1
	},
/obj/effect/turf_decal/siding/dark{
	dir = 1
	},
/obj/effect/turf_decal/trimline/neutral/filled/line{
	dir = 1
	},
/obj/effect/turf_decal/trimline/neutral/filled/mid_joiner{
	dir = 1
	},
/turf/open/floor/iron/dark/smooth_large,
/area/shuttle/arrival)

(1,1,1) = {"
a
b
m
m
b
a
"}
(2,1,1) = {"
b
G
E
q
J
b
"}
(3,1,1) = {"
b
w
I
n
O
b
"}
(4,1,1) = {"
b
b
C
C
b
b
"}
(5,1,1) = {"
U
X
o
o
f
c
"}
(6,1,1) = {"
b
Y
K
V
x
b
"}
(7,1,1) = {"
d
h
Z
B
N
d
"}
(8,1,1) = {"
d
h
Z
B
N
d
"}
(9,1,1) = {"
d
h
Z
B
N
d
"}
(10,1,1) = {"
b
P
g
R
u
b
"}
(11,1,1) = {"
U
z
H
H
F
c
"}
(12,1,1) = {"
b
k
k
k
k
b
"}
(13,1,1) = {"
b
l
p
r
v
b
"}
