//MAP CONVERTED BY dmm2tgm.py THIS HEADER COMMENT PREVENTS RECONVERSION, DO NOT REMOVE
"a" = (
/turf/closed/wall/mineral/titanium,
/area/shuttle/supply)
"b" = (
/obj/machinery/door/airlock/shuttle{
	name = "Supply Shuttle Airlock"
	},
/obj/effect/mapping_helpers/airlock/access/all/supply/general,
/obj/effect/decal/cleanable/dirt/dust,
/obj/effect/decal/cleanable/dirt,
/obj/effect/turf_decal/siding/dark/end,
/turf/open/floor/iron/dark/textured_large,
/area/shuttle/supply)
"h" = (
/obj/machinery/door/airlock/shuttle{
	name = "Supply Shuttle Airlock"
	},
/obj/effect/mapping_helpers/airlock/access/all/supply/general,
/obj/effect/decal/cleanable/dirt/dust,
/obj/effect/turf_decal/siding/dark/end{
	dir = 1
	},
/turf/open/floor/iron/dark/textured_large,
/area/shuttle/supply)
"j" = (
/obj/effect/decal/cleanable/dirt/dust,
/obj/effect/turf_decal/bot,
/obj/effect/turf_decal/trimline/neutral/filled/line{
	dir = 1
	},
/obj/effect/turf_decal/trimline/neutral/filled/mid_joiner{
	dir = 1
	},
/turf/open/floor/iron/dark/textured_large,
/area/shuttle/supply)
"l" = (
/obj/effect/decal/cleanable/dirt/dust,
/obj/effect/turf_decal/delivery,
/obj/effect/turf_decal/trimline/neutral/filled/line,
/obj/effect/turf_decal/trimline/neutral/filled/mid_joiner,
/turf/open/floor/iron/dark/textured_large,
/area/shuttle/supply)
"m" = (
/obj/effect/decal/cleanable/dirt/dust,
/obj/effect/decal/cleanable/dirt,
/obj/effect/turf_decal/siding/dark,
/obj/effect/turf_decal/trimline/neutral/filled/line,
/obj/effect/turf_decal/trimline/neutral/filled/mid_joiner,
/turf/open/floor/iron/edge,
/area/shuttle/supply)
"p" = (
/obj/effect/decal/cleanable/dirt/dust,
/obj/effect/decal/cleanable/dirt,
/turf/open/floor/iron,
/area/shuttle/supply)
"q" = (
/obj/machinery/light/directional/east,
/obj/effect/decal/cleanable/dirt/dust,
/obj/effect/turf_decal/trimline/neutral/filled/line{
	dir = 4
	},
/obj/effect/turf_decal/trimline/neutral/filled/mid_joiner{
	dir = 4
	},
/turf/open/floor/iron/edge{
	dir = 4
	},
/area/shuttle/supply)
"r" = (
/obj/machinery/conveyor{
	dir = 8;
	id = "CargoUnload";
	name = "Cargo Unload"
	},
/obj/machinery/door/poddoor{
	id = "QMLoaddoor2";
	name = "Supply Dock Loading Door"
	},
/obj/effect/decal/cleanable/dirt/dust,
/obj/effect/turf_decal/trimline/neutral/filled/corner{
	dir = 4
	},
/turf/open/floor/iron/dark/textured_large,
/area/shuttle/supply)
"s" = (
/obj/effect/decal/cleanable/dirt/dust,
/obj/effect/turf_decal/loading_area{
	dir = 4
	},
/obj/effect/turf_decal/trimline/neutral/filled/line,
/obj/effect/turf_decal/trimline/neutral/filled/mid_joiner,
/obj/effect/decal/cleanable/oil,
/turf/open/floor/iron/dark/textured_large,
/area/shuttle/supply)
"u" = (
/obj/effect/decal/cleanable/dirt/dust,
/obj/effect/decal/cleanable/dirt,
/obj/effect/turf_decal/bot,
/obj/effect/turf_decal/trimline/neutral/filled/line{
	dir = 1
	},
/obj/effect/turf_decal/trimline/neutral/filled/mid_joiner{
	dir = 1
	},
/turf/open/floor/iron/dark/textured_large,
/area/shuttle/supply)
"v" = (
/obj/effect/decal/cleanable/dirt/dust,
/obj/effect/turf_decal/siding/dark{
	dir = 1
	},
/obj/effect/turf_decal/trimline/neutral/filled/line{
	dir = 1
	},
/obj/effect/turf_decal/trimline/neutral/filled/mid_joiner{
	dir = 1
	},
/turf/open/floor/iron/edge{
	dir = 1
	},
/area/shuttle/supply)
"w" = (
/obj/effect/decal/cleanable/dirt/dust,
/obj/effect/turf_decal/bot,
/obj/effect/decal/cleanable/oil,
/turf/open/floor/iron/dark/textured_large,
/area/shuttle/supply)
"x" = (
/obj/effect/decal/cleanable/dirt/dust,
/obj/effect/turf_decal/bot,
/turf/open/floor/iron/dark/textured_large,
/area/shuttle/supply)
"y" = (
/obj/effect/decal/cleanable/dirt/dust,
/obj/effect/decal/cleanable/dirt,
/obj/effect/turf_decal/bot,
/turf/open/floor/iron/dark/textured_large,
/area/shuttle/supply)
"z" = (
/obj/structure/window/reinforced/spawner/directional/north,
/obj/machinery/power/shuttle_engine/heater,
/obj/effect/turf_decal/stripes/line,
/turf/open/floor/iron/dark/textured_large/airless,
/area/shuttle/supply)
"B" = (
/turf/template_noop,
/area/template_noop)
"C" = (
/obj/machinery/power/shuttle_engine/propulsion/burst/left,
/obj/effect/turf_decal/stripes/line,
/turf/open/floor/iron/dark/textured_large/airless,
/area/shuttle/supply)
"D" = (
/obj/machinery/power/shuttle_engine/propulsion,
/obj/effect/turf_decal/stripes/line,
/turf/open/floor/iron/dark/textured_large/airless,
/area/shuttle/supply)
"E" = (
/obj/machinery/power/shuttle_engine/propulsion/burst/right,
/obj/effect/turf_decal/stripes/line,
/turf/open/floor/iron/dark/textured_large/airless,
/area/shuttle/supply)
"F" = (
/obj/effect/decal/cleanable/dirt/dust,
/obj/effect/turf_decal/siding/dark,
/obj/effect/turf_decal/trimline/neutral/filled/line,
/obj/effect/turf_decal/trimline/neutral/filled/mid_joiner,
/turf/open/floor/iron/edge,
/area/shuttle/supply)
"H" = (
/obj/effect/decal/cleanable/dirt/dust,
/obj/effect/turf_decal/bot,
/obj/effect/turf_decal/trimline/neutral/filled/line,
/obj/effect/turf_decal/trimline/neutral/filled/mid_joiner,
/turf/open/floor/iron/dark/textured_large,
/area/shuttle/supply)
"I" = (
/obj/machinery/light/small/directional/north,
/obj/effect/decal/cleanable/dirt/dust,
/obj/effect/decal/cleanable/dirt,
/obj/effect/turf_decal/bot,
/turf/open/floor/iron/dark/textured_large,
/area/shuttle/supply)
"K" = (
/obj/effect/decal/cleanable/dirt/dust,
/obj/effect/turf_decal/siding/dark,
/obj/effect/turf_decal/trimline/neutral/filled/warning{
	dir = 10
	},
/obj/effect/turf_decal/trimline/neutral/mid_joiner{
	dir = 8
	},
/obj/effect/turf_decal/trimline/neutral/mid_joiner,
/turf/open/floor/iron/corner{
	dir = 4
	},
/area/shuttle/supply)
"L" = (
/obj/machinery/conveyor{
	dir = 4;
	id = "CargoLoad";
	name = "Cargo Load"
	},
/obj/machinery/door/poddoor{
	id = "QMLoaddoor";
	name = "Supply Dock Loading Door"
	},
/obj/effect/decal/cleanable/dirt/dust,
/obj/effect/turf_decal/trimline/neutral/filled/corner,
/turf/open/floor/iron/dark/textured_large,
/area/shuttle/supply)
"M" = (
/obj/machinery/button/door/directional/east{
	id = "QMLoaddoor2";
	name = "Loading Doors";
	pixel_y = -7;
	pixel_x = -26
	},
/obj/machinery/button/door/directional/east{
	id = "QMLoaddoor";
	name = "Loading Doors";
	pixel_y = 6;
	pixel_x = -26
	},
/obj/machinery/light/directional/west,
/obj/effect/decal/cleanable/dirt/dust,
/obj/effect/turf_decal/trimline/neutral/filled/line{
	dir = 8
	},
/obj/effect/turf_decal/trimline/neutral/filled/mid_joiner{
	dir = 8
	},
/turf/open/floor/iron/edge{
	dir = 8
	},
/area/shuttle/supply)
"N" = (
/obj/effect/decal/cleanable/dirt/dust,
/obj/effect/turf_decal/siding/dark{
	dir = 1
	},
/obj/effect/turf_decal/trimline/neutral/filled/line{
	dir = 5
	},
/obj/effect/turf_decal/trimline/neutral/filled/mid_joiner{
	dir = 4
	},
/obj/effect/turf_decal/trimline/neutral/filled/mid_joiner{
	dir = 1
	},
/turf/open/floor/iron/corner{
	dir = 8
	},
/area/shuttle/supply)
"P" = (
/obj/effect/decal/cleanable/dirt/dust,
/obj/effect/turf_decal/siding/dark{
	dir = 1
	},
/obj/effect/turf_decal/trimline/neutral/filled/warning{
	dir = 9
	},
/obj/effect/turf_decal/trimline/neutral/mid_joiner{
	dir = 8
	},
/obj/effect/turf_decal/trimline/neutral/mid_joiner{
	dir = 1
	},
/turf/open/floor/iron/corner,
/area/shuttle/supply)
"Q" = (
/obj/effect/decal/cleanable/dirt/dust,
/obj/effect/decal/cleanable/dirt,
/obj/effect/turf_decal/siding/dark{
	dir = 1
	},
/obj/effect/turf_decal/trimline/neutral/filled/line{
	dir = 1
	},
/obj/effect/turf_decal/trimline/neutral/filled/mid_joiner{
	dir = 1
	},
/turf/open/floor/iron/edge{
	dir = 1
	},
/area/shuttle/supply)
"R" = (
/obj/docking_port/mobile/supply{
	dir = 4;
	port_direction = 8
	},
/turf/closed/wall/mineral/titanium,
/area/shuttle/supply)
"S" = (
/obj/effect/spawner/structure/window/reinforced/shuttle,
/turf/open/floor/plating,
/area/shuttle/supply)
"T" = (
/obj/machinery/light/small/directional/south,
/obj/effect/decal/cleanable/dirt/dust,
/obj/effect/decal/cleanable/dirt,
/obj/effect/turf_decal/bot,
/turf/open/floor/iron/dark/textured_large,
/area/shuttle/supply)
"U" = (
/obj/effect/decal/cleanable/dirt/dust,
/obj/effect/turf_decal/delivery,
/obj/effect/turf_decal/trimline/neutral/filled/line{
	dir = 1
	},
/obj/effect/turf_decal/trimline/neutral/filled/mid_joiner{
	dir = 1
	},
/turf/open/floor/iron/dark/textured_large,
/area/shuttle/supply)
"V" = (
/obj/effect/decal/cleanable/dirt/dust,
/turf/open/floor/iron,
/area/shuttle/supply)
"X" = (
/obj/effect/decal/cleanable/dirt/dust,
/obj/effect/turf_decal/loading_area{
	dir = 8
	},
/obj/effect/turf_decal/trimline/neutral/filled/line{
	dir = 1
	},
/obj/effect/turf_decal/trimline/neutral/filled/mid_joiner{
	dir = 1
	},
/turf/open/floor/iron/dark/textured_large,
/area/shuttle/supply)
"Z" = (
/obj/effect/decal/cleanable/dirt/dust,
/obj/effect/turf_decal/siding/dark,
/obj/effect/turf_decal/trimline/neutral/filled/line{
	dir = 6
	},
/obj/effect/turf_decal/trimline/neutral/filled/mid_joiner,
/obj/effect/turf_decal/trimline/neutral/filled/mid_joiner{
	dir = 4
	},
/turf/open/floor/iron/corner{
	dir = 1
	},
/area/shuttle/supply)

(1,1,1) = {"
a
a
S
L
h
R
b
r
S
a
a
B
"}
(2,1,1) = {"
a
I
x
s
P
M
K
X
x
T
a
C
"}
(3,1,1) = {"
S
x
y
l
v
p
m
U
x
x
z
D
"}
(4,1,1) = {"
a
x
x
H
v
V
F
j
y
y
z
D
"}
(5,1,1) = {"
S
x
x
H
Q
V
F
u
w
x
z
D
"}
(6,1,1) = {"
a
I
y
H
N
q
Z
j
x
T
a
E
"}
(7,1,1) = {"
a
a
S
a
a
a
a
a
S
a
a
B
"}
