//MAP CONVERTED BY dmm2tgm.py THIS HEADER COMMENT PREVENTS RECONVERSION, DO NOT REMOVE
"a" = (
/turf/closed/wall/mineral/plastitanium,
/area/shuttle/transport)
"c" = (
/obj/effect/turf_decal/siding/dark,
/obj/structure/chair/comfy/shuttle{
	dir = 8
	},
/obj/effect/turf_decal/trimline/neutral/filled/line,
/obj/effect/turf_decal/trimline/neutral/filled/mid_joiner,
/turf/open/floor/iron/dark/smooth_large,
/area/shuttle/transport)
"e" = (
/obj/effect/turf_decal/siding/dark{
	dir = 1
	},
/obj/structure/chair/comfy/shuttle{
	dir = 1
	},
/obj/structure/window/reinforced/survival_pod/spawner/directional/east,
/obj/effect/turf_decal/trimline/neutral/filled/line{
	dir = 1
	},
/obj/effect/turf_decal/trimline/neutral/filled/mid_joiner{
	dir = 1
	},
/turf/open/floor/iron/dark/smooth_large,
/area/shuttle/transport)
"i" = (
/turf/template_noop,
/area/template_noop)
"j" = (
/obj/effect/turf_decal/siding/dark,
/turf/closed/wall/mineral/titanium,
/area/shuttle/transport)
"k" = (
/turf/open/floor/iron/dark/smooth_large,
/area/shuttle/transport)
"l" = (
/obj/effect/spawner/structure/window/reinforced/shuttle,
/turf/open/floor/plating,
/area/shuttle/transport)
"m" = (
/obj/machinery/power/shuttle_engine/heater{
	dir = 8
	},
/obj/structure/window/reinforced/survival_pod/spawner/directional/east,
/obj/effect/turf_decal/stripes{
	dir = 4
	},
/obj/effect/turf_decal/stripes/white/line{
	dir = 4
	},
/turf/open/floor/iron/dark/textured_large/airless,
/area/shuttle/transport)
"n" = (
/obj/effect/turf_decal/siding/dark,
/obj/structure/chair/comfy/shuttle,
/obj/structure/window/reinforced/survival_pod/spawner/directional/east,
/obj/effect/turf_decal/trimline/neutral/filled/line,
/obj/effect/turf_decal/trimline/neutral/filled/mid_joiner,
/turf/open/floor/iron/dark/smooth_large,
/area/shuttle/transport)
"o" = (
/obj/structure/chair/comfy/shuttle{
	dir = 8
	},
/turf/open/floor/iron/dark/smooth_large,
/area/shuttle/transport)
"p" = (
/obj/effect/turf_decal/siding/dark{
	dir = 8
	},
/obj/structure/fans/tiny,
/obj/effect/turf_decal/stripes{
	dir = 4
	},
/obj/effect/turf_decal/stripes/white/line{
	dir = 4
	},
/obj/effect/turf_decal/trimline/neutral/filled/line{
	dir = 8
	},
/obj/effect/turf_decal/trimline/neutral/filled/mid_joiner{
	dir = 8
	},
/obj/machinery/door/airlock/shuttle{
	name = "Ferry Shuttle Airlock"
	},
/obj/docking_port/mobile{
	dir = 8;
	shuttle_id = "ferry";
	name = "ferry shuttle";
	preferred_direction = 4
	},
/turf/open/floor/iron/dark/textured_large,
/area/shuttle/transport)
"s" = (
/obj/structure/table/reinforced/titaniumglass,
/obj/item/reagent_containers/cup/glass/coffee{
	pixel_y = 10;
	pixel_x = -6
	},
/obj/item/phone{
	pixel_x = 5;
	pixel_y = -1
	},
/turf/open/floor/iron/dark/smooth_large,
/area/shuttle/transport)
"t" = (
/obj/effect/turf_decal/trimline/neutral/filled/line{
	dir = 8
	},
/obj/effect/turf_decal/trimline/neutral/filled/corner,
/obj/effect/turf_decal/trimline/neutral/filled/corner{
	dir = 4
	},
/turf/open/floor/iron,
/area/shuttle/transport)
"u" = (
/obj/effect/turf_decal/trimline/neutral/filled/line{
	dir = 8
	},
/obj/effect/turf_decal/trimline/neutral/filled/line{
	dir = 4
	},
/turf/open/floor/iron,
/area/shuttle/transport)
"v" = (
/obj/effect/turf_decal/siding/dark,
/obj/structure/chair/comfy/shuttle{
	dir = 4
	},
/obj/effect/turf_decal/trimline/neutral/filled/line,
/obj/effect/turf_decal/trimline/neutral/filled/mid_joiner,
/turf/open/floor/iron/dark/smooth_large,
/area/shuttle/transport)
"w" = (
/obj/effect/turf_decal/siding/dark,
/obj/structure/table/reinforced/titaniumglass,
/obj/effect/spawner/random/food_or_drink/snack,
/obj/effect/turf_decal/trimline/neutral/filled/line,
/obj/effect/turf_decal/trimline/neutral/filled/mid_joiner,
/turf/open/floor/iron/dark/smooth_large,
/area/shuttle/transport)
"x" = (
/obj/structure/sign/nanotrasen,
/turf/closed/wall/mineral/titanium,
/area/shuttle/transport)
"y" = (
/obj/structure/chair/comfy/shuttle,
/obj/effect/turf_decal/siding/dark{
	dir = 10
	},
/obj/structure/window/reinforced/survival_pod/spawner/directional/west,
/obj/effect/turf_decal/trimline/neutral/filled/line,
/obj/effect/turf_decal/trimline/neutral/filled/mid_joiner,
/turf/open/floor/iron/dark/smooth_large,
/area/shuttle/transport)
"A" = (
/obj/effect/turf_decal/siding/dark{
	dir = 1
	},
/obj/structure/chair/comfy/shuttle{
	dir = 4
	},
/obj/effect/turf_decal/trimline/neutral/filled/line{
	dir = 1
	},
/obj/effect/turf_decal/trimline/neutral/filled/mid_joiner{
	dir = 1
	},
/turf/open/floor/iron/dark/smooth_large,
/area/shuttle/transport)
"C" = (
/obj/effect/turf_decal/siding/dark{
	dir = 4
	},
/obj/effect/turf_decal/trimline/neutral/filled/line{
	dir = 4
	},
/obj/effect/turf_decal/trimline/neutral/filled/mid_joiner{
	dir = 4
	},
/turf/open/floor/iron/dark/smooth_large,
/area/shuttle/transport)
"D" = (
/obj/machinery/power/shuttle_engine/propulsion/left{
	dir = 8
	},
/turf/open/floor/iron/dark/textured_large/airless,
/area/shuttle/transport)
"E" = (
/obj/effect/turf_decal/siding/dark{
	dir = 4
	},
/obj/effect/turf_decal/trimline/neutral/filled/line{
	dir = 4
	},
/obj/effect/turf_decal/trimline/neutral/filled/mid_joiner{
	dir = 4
	},
/obj/structure/window/reinforced/survival_pod/spawner/directional/east,
/obj/item/kirbyplants/organic/plant22,
/turf/open/floor/iron/dark/smooth_large,
/area/shuttle/transport)
"F" = (
/obj/effect/turf_decal/siding/dark{
	dir = 1
	},
/obj/structure/table/reinforced/titaniumglass,
/obj/effect/spawner/random/food_or_drink/refreshing_beverage,
/obj/effect/turf_decal/trimline/neutral/filled/line{
	dir = 1
	},
/obj/effect/turf_decal/trimline/neutral/filled/mid_joiner{
	dir = 1
	},
/turf/open/floor/iron/dark/smooth_large,
/area/shuttle/transport)
"G" = (
/obj/effect/turf_decal/siding/dark{
	dir = 1
	},
/turf/closed/wall/mineral/titanium,
/area/shuttle/transport)
"J" = (
/obj/effect/turf_decal/siding/dark{
	dir = 1
	},
/obj/structure/fans/tiny,
/obj/effect/turf_decal/stripes,
/obj/effect/turf_decal/stripes/white/line,
/obj/effect/turf_decal/trimline/neutral/filled/line{
	dir = 1
	},
/obj/effect/turf_decal/trimline/neutral/filled/mid_joiner{
	dir = 1
	},
/obj/machinery/door/airlock/external/ruin{
	name = "Ferry External Airlock"
	},
/turf/open/floor/iron/dark/textured_large,
/area/shuttle/transport)
"L" = (
/obj/effect/turf_decal/siding/dark,
/obj/structure/fans/tiny,
/obj/effect/turf_decal/stripes{
	dir = 1
	},
/obj/effect/turf_decal/stripes/white/line{
	dir = 1
	},
/obj/effect/turf_decal/trimline/neutral/filled/line,
/obj/effect/turf_decal/trimline/neutral/filled/mid_joiner,
/obj/machinery/door/airlock/external/ruin{
	name = "Ferry External Airlock"
	},
/turf/open/floor/iron/dark/textured_large,
/area/shuttle/transport)
"N" = (
/obj/machinery/power/shuttle_engine/heater{
	dir = 8
	},
/obj/effect/turf_decal/stripes{
	dir = 4
	},
/obj/effect/turf_decal/stripes/white/line{
	dir = 4
	},
/obj/structure/window/reinforced/survival_pod/spawner/directional/east,
/turf/open/floor/iron/dark/textured_large/airless,
/area/shuttle/transport)
"P" = (
/obj/effect/turf_decal/trimline/neutral/filled/line,
/obj/effect/turf_decal/trimline/neutral/filled/line{
	dir = 1
	},
/turf/open/floor/iron,
/area/shuttle/transport)
"S" = (
/obj/structure/table/reinforced/titaniumglass,
/obj/machinery/recharger{
	pixel_x = -6;
	pixel_y = 2
	},
/obj/machinery/recharger{
	pixel_x = 6;
	pixel_y = 2
	},
/turf/open/floor/iron/dark/smooth_large,
/area/shuttle/transport)
"T" = (
/obj/machinery/digital_clock/directional/south,
/obj/machinery/digital_clock/directional/north,
/obj/effect/turf_decal/trimline/neutral/filled/line,
/obj/effect/turf_decal/trimline/neutral/filled/line{
	dir = 1
	},
/turf/open/floor/iron,
/area/shuttle/transport)
"U" = (
/obj/structure/chair/comfy/shuttle{
	dir = 1
	},
/obj/effect/turf_decal/siding/dark{
	dir = 9
	},
/obj/structure/window/reinforced/survival_pod/spawner/directional/west,
/obj/effect/turf_decal/trimline/neutral/filled/line{
	dir = 1
	},
/obj/effect/turf_decal/trimline/neutral/filled/mid_joiner{
	dir = 1
	},
/turf/open/floor/iron/dark/smooth_large,
/area/shuttle/transport)
"V" = (
/obj/machinery/computer/shuttle/ferry/request{
	dir = 4
	},
/turf/open/floor/iron/dark/smooth_large,
/area/shuttle/transport)
"W" = (
/obj/effect/turf_decal/siding/dark{
	dir = 1
	},
/obj/structure/chair/comfy/shuttle{
	dir = 8
	},
/obj/effect/turf_decal/trimline/neutral/filled/line{
	dir = 1
	},
/obj/effect/turf_decal/trimline/neutral/filled/mid_joiner{
	dir = 1
	},
/turf/open/floor/iron/dark/smooth_large,
/area/shuttle/transport)
"Z" = (
/turf/closed/wall/mineral/titanium,
/area/shuttle/transport)

(1,1,1) = {"
i
D
D
D
i
"}
(2,1,1) = {"
a
m
N
m
a
"}
(3,1,1) = {"
x
S
V
s
x
"}
(4,1,1) = {"
l
k
o
k
l
"}
(5,1,1) = {"
Z
E
C
E
Z
"}
(6,1,1) = {"
L
u
t
u
J
"}
(7,1,1) = {"
Z
y
P
U
Z
"}
(8,1,1) = {"
Z
n
P
e
Z
"}
(9,1,1) = {"
Z
v
P
A
Z
"}
(10,1,1) = {"
l
w
P
F
l
"}
(11,1,1) = {"
Z
c
P
W
Z
"}
(12,1,1) = {"
x
j
T
G
x
"}
(13,1,1) = {"
i
Z
p
Z
i
"}
