//MAP CONVERTED BY dmm2tgm.py THIS HEADER COMMENT PREVENTS RECONVERSION, DO NOT REMOVE
"ah" = (
/obj/structure/sign/poster/ripped/directional/south,
/obj/effect/decal/cleanable/dirt/dust,
/obj/effect/mapping_helpers/burnt_floor,
/turf/open/floor/plating,
/area/shuttle/abandoned)
"ap" = (
/obj/structure/table,
/obj/machinery/microwave,
/obj/effect/decal/cleanable/dirt/dust,
/turf/open/floor/plating,
/area/shuttle/abandoned)
"aq" = (
/obj/machinery/light/small/built/directional/west,
/obj/effect/decal/cleanable/dirt/dust,
/obj/effect/mapping_helpers/burnt_floor,
/turf/open/floor/plating,
/area/shuttle/abandoned)
"bH" = (
/obj/structure/closet/emcloset/anchored,
/obj/effect/turf_decal/delivery/white,
/obj/effect/decal/cleanable/dirt,
/turf/open/floor/plating,
/area/shuttle/abandoned)
"bP" = (
/obj/machinery/atmospherics/pipe/smart/manifold4w/supply/hidden/layer4,
/obj/effect/decal/cleanable/dirt,
/obj/effect/mapping_helpers/burnt_floor,
/turf/open/floor/plating,
/area/shuttle/abandoned)
"cx" = (
/obj/machinery/atmospherics/pipe/smart/manifold4w/supply/hidden/layer4,
/obj/effect/decal/cleanable/dirt/dust,
/obj/effect/mapping_helpers/burnt_floor,
/turf/open/floor/iron/small,
/area/shuttle/abandoned)
"cE" = (
/obj/effect/turf_decal/bot_white,
/obj/machinery/atmospherics/components/tank/air/layer4{
	dir = 1
	},
/obj/effect/decal/cleanable/dirt,
/turf/open/floor/plating,
/area/shuttle/abandoned)
"cS" = (
/obj/machinery/atmospherics/pipe/smart/manifold4w/supply/hidden/layer4,
/obj/effect/decal/cleanable/dirt/dust,
/obj/effect/mapping_helpers/broken_floor,
/turf/open/floor/plating,
/area/shuttle/abandoned)
"ef" = (
/obj/structure/closet/firecloset/full{
	anchored = 1
	},
/obj/effect/decal/cleanable/dirt/dust,
/obj/effect/mapping_helpers/burnt_floor,
/turf/open/floor/plating,
/area/shuttle/abandoned)
"eI" = (
/obj/machinery/holopad/secure,
/obj/effect/decal/cleanable/dirt/dust,
/obj/effect/mapping_helpers/burnt_floor,
/turf/open/floor/iron/dark/small,
/area/shuttle/abandoned)
"eU" = (
/obj/machinery/atmospherics/components/unary/vent_pump/on/layer4{
	dir = 4
	},
/obj/effect/decal/cleanable/dirt/dust,
/obj/effect/mapping_helpers/broken_floor,
/turf/open/floor/plating,
/area/shuttle/abandoned)
"fr" = (
/obj/structure/frame/computer,
/obj/item/shard,
/obj/effect/decal/cleanable/dirt/dust,
/turf/open/floor/plating,
/area/shuttle/abandoned)
"gN" = (
/obj/structure/table,
/obj/machinery/reagentgrinder{
	pixel_x = -1;
	pixel_y = 8
	},
/obj/item/reagent_containers/cup/beaker/large{
	pixel_x = -3;
	pixel_y = 3
	},
/obj/item/reagent_containers/cup/beaker{
	pixel_x = 8;
	pixel_y = 2
	},
/obj/item/reagent_containers/dropper,
/obj/effect/decal/cleanable/dirt/dust,
/turf/open/floor/iron/dark/textured_large,
/area/shuttle/abandoned)
"gQ" = (
/obj/structure/table,
/obj/item/swab{
	pixel_x = 6;
	pixel_y = 7
	},
/obj/item/food/breadslice/moldy/bacteria{
	pixel_x = -3;
	pixel_y = 4
	},
/obj/machinery/light/small/broken/directional/north,
/obj/effect/decal/cleanable/dirt/dust,
/obj/effect/mapping_helpers/burnt_floor,
/turf/open/floor/plating,
/area/shuttle/abandoned)
"hM" = (
/obj/machinery/atmospherics/pipe/smart/manifold4w/supply/hidden/layer4,
/obj/effect/mapping_helpers/airlock/cyclelink_helper{
	dir = 4
	},
/obj/effect/turf_decal/stripes{
	dir = 8
	},
/obj/effect/turf_decal/stripes/white/line{
	dir = 8
	},
/obj/machinery/door/airlock/external/ruin,
/obj/effect/decal/cleanable/dirt,
/obj/effect/mapping_helpers/burnt_floor,
/turf/open/floor/plating,
/area/shuttle/abandoned)
"hP" = (
/obj/structure/closet/crate/science,
/obj/item/raw_anomaly_core/random{
	pixel_x = -5;
	pixel_y = 7
	},
/obj/item/raw_anomaly_core/random,
/obj/item/disk/design_disk/bepis{
	pixel_x = -3;
	pixel_y = -3
	},
/obj/item/disk/design_disk/bepis,
/obj/item/disk/design_disk/bepis{
	pixel_x = 3;
	pixel_y = 3
	},
/obj/effect/decal/cleanable/dirt/dust,
/turf/open/floor/plating,
/area/shuttle/abandoned)
"hV" = (
/obj/machinery/light/small/built/directional/north,
/obj/structure/table,
/obj/effect/spawner/random/food_or_drink/donkpockets{
	pixel_y = 5
	},
/obj/item/reagent_containers/cup/glass/mug/nanotrasen{
	pixel_y = 9;
	pixel_x = 10
	},
/obj/effect/decal/cleanable/dirt/dust,
/turf/open/floor/plating,
/area/shuttle/abandoned)
"jT" = (
/turf/closed/wall/mineral/titanium,
/area/shuttle/abandoned)
"km" = (
/obj/machinery/atmospherics/pipe/smart/manifold4w/supply/hidden/layer4,
/obj/effect/decal/cleanable/ants/fire,
/obj/effect/decal/cleanable/dirt/dust,
/obj/effect/mapping_helpers/burnt_floor,
/turf/open/floor/plating,
/area/shuttle/abandoned)
"kZ" = (
/obj/structure/closet/crate/radiation,
/obj/item/lazarus_injector,
/obj/machinery/light/small/broken/directional/east,
/obj/effect/decal/cleanable/dirt/dust,
/turf/open/floor/iron/dark/small,
/area/shuttle/abandoned)
"lO" = (
/obj/effect/turf_decal/bot_white,
/obj/structure/closet/crate/science,
/obj/item/stack/sheet/iron/twenty,
/obj/item/stack/sheet/glass{
	amount = 10
	},
/obj/item/stack/sheet/mineral/plasma{
	amount = 10
	},
/obj/effect/decal/cleanable/dirt/dust,
/turf/open/floor/plating,
/area/shuttle/abandoned)
"lS" = (
/obj/structure/table,
/obj/machinery/button/door/directional/north{
	id = "whiteship_bridge";
	name = "Bridge Blast Door Control";
	pixel_y = 28
	},
/obj/machinery/recharger,
/obj/effect/decal/cleanable/dirt/dust,
/turf/open/floor/plating,
/area/shuttle/abandoned)
"lV" = (
/obj/machinery/computer/camera_advanced/shuttle_docker/whiteship{
	y_offset = 2;
	x_offset = -8
	},
/obj/effect/decal/cleanable/cobweb/cobweb2,
/obj/effect/decal/cleanable/dirt/dust,
/turf/open/floor/iron/dark/small,
/area/shuttle/abandoned)
"mm" = (
/obj/machinery/atmospherics/pipe/smart/manifold4w/supply/hidden/layer4,
/obj/effect/decal/cleanable/dirt/dust,
/turf/open/floor/iron/small,
/area/shuttle/abandoned)
"na" = (
/obj/machinery/light/small/built/directional/east,
/obj/effect/decal/cleanable/oil,
/obj/structure/cable,
/obj/effect/decal/cleanable/dirt,
/turf/open/floor/plating,
/area/shuttle/abandoned)
"nQ" = (
/obj/effect/decal/remains/human,
/obj/effect/decal/cleanable/dirt/dust,
/turf/open/floor/iron/dark/small,
/area/shuttle/abandoned)
"oI" = (
/obj/structure/bookcase/manuals/research_and_development,
/obj/effect/decal/cleanable/dirt/dust,
/turf/open/floor/plating,
/area/shuttle/abandoned)
"oT" = (
/obj/effect/decal/cleanable/dirt/dust,
/obj/structure/reagent_dispensers/fueltank/large,
/turf/open/floor/plating,
/area/shuttle/abandoned)
"oY" = (
/obj/structure/sign/departments/engineering/directional/east,
/obj/effect/decal/cleanable/dirt/dust,
/turf/open/floor/iron/small,
/area/shuttle/abandoned)
"pk" = (
/obj/structure/chair/office/light,
/obj/effect/decal/cleanable/dirt/dust,
/turf/open/floor/iron/white/small,
/area/shuttle/abandoned)
"pq" = (
/obj/machinery/light/small/broken/directional/east,
/obj/effect/decal/cleanable/dirt/dust,
/obj/effect/mapping_helpers/burnt_floor,
/turf/open/floor/iron/small,
/area/shuttle/abandoned)
"pN" = (
/obj/machinery/atmospherics/pipe/smart/manifold4w/supply/hidden/layer4,
/obj/effect/turf_decal/stripes{
	dir = 4
	},
/obj/effect/turf_decal/stripes/white/line{
	dir = 4
	},
/obj/machinery/door/airlock/external/ruin,
/obj/effect/decal/cleanable/dirt,
/obj/effect/mapping_helpers/airlock/cyclelink_helper_multi{
	cycle_id = "whiteship"
	},
/turf/open/floor/plating,
/area/shuttle/abandoned)
"pV" = (
/obj/machinery/atmospherics/pipe/smart/manifold4w/supply/hidden/layer4,
/obj/effect/decal/cleanable/ants,
/obj/effect/decal/cleanable/dirt,
/turf/open/floor/plating,
/area/shuttle/abandoned)
"qS" = (
/obj/structure/table,
/obj/machinery/cell_charger,
/obj/item/stock_parts/power_store/cell/high,
/obj/effect/turf_decal/bot_white,
/obj/item/stack/cable_coil,
/obj/item/multitool,
/obj/effect/decal/cleanable/dirt/dust,
/turf/open/floor/iron/white/small,
/area/shuttle/abandoned)
"re" = (
/obj/structure/cable,
/obj/effect/turf_decal/bot_white,
/obj/structure/table,
/obj/item/assembly/flash{
	pixel_x = 5;
	pixel_y = 9
	},
/obj/item/book/manual/wiki/cytology{
	pixel_x = -4;
	pixel_y = 4
	},
/obj/item/book/manual/wiki/research_and_development,
/obj/item/biopsy_tool{
	pixel_x = 8;
	pixel_y = 2
	},
/obj/effect/decal/cleanable/dirt/dust,
/turf/open/floor/iron/white/small,
/area/shuttle/abandoned)
"rl" = (
/obj/structure/closet,
/obj/item/clothing/suit/toggle/labcoat,
/obj/item/clothing/neck/tie/horrible,
/obj/effect/decal/cleanable/dirt/dust,
/turf/open/floor/plating,
/area/shuttle/abandoned)
"rV" = (
/obj/effect/gibspawner/human/bodypartless,
/obj/item/gun/energy/laser/retro{
	pixel_x = 4;
	pixel_y = -6
	},
/obj/effect/decal/cleanable/dirt/dust,
/obj/effect/mapping_helpers/burnt_floor,
/turf/open/floor/iron/dark/small,
/area/shuttle/abandoned)
"sl" = (
/obj/machinery/door/poddoor{
	id = "whiteship_bridge"
	},
/obj/effect/spawner/structure/window/reinforced/shuttle,
/turf/open/floor/plating,
/area/shuttle/abandoned)
"sx" = (
/obj/machinery/atmospherics/components/unary/vent_pump/on/layer4{
	dir = 4
	},
/obj/effect/decal/cleanable/dirt,
/obj/effect/mapping_helpers/burnt_floor,
/turf/open/floor/plating,
/area/shuttle/abandoned)
"sy" = (
/obj/machinery/light/broken/directional/south,
/obj/machinery/atmospherics/pipe/smart/manifold4w/supply/hidden/layer4,
/obj/effect/decal/cleanable/dirt/dust,
/obj/effect/mapping_helpers/burnt_floor,
/turf/open/floor/iron/small,
/area/shuttle/abandoned)
"sW" = (
/obj/machinery/atmospherics/pipe/smart/manifold4w/supply/hidden/layer4,
/mob/living/basic/ant{
	faction = list("spiders")
	},
/obj/machinery/power/terminal,
/obj/structure/cable,
/obj/effect/decal/cleanable/dirt,
/obj/effect/mapping_helpers/burnt_floor,
/turf/open/floor/plating,
/area/shuttle/abandoned)
"sY" = (
/obj/structure/closet/crate/freezer,
/obj/item/food/meat/slab/human/mutant/golem/adamantine,
/obj/item/storage/fancy/donut_box,
/obj/effect/spawner/random/maintenance,
/obj/effect/spawner/random/food_or_drink/booze,
/obj/effect/decal/cleanable/dirt/dust,
/turf/open/floor/plating,
/area/shuttle/abandoned)
"uO" = (
/obj/item/kirbyplants/random/dead,
/obj/effect/decal/cleanable/dirt/dust,
/turf/open/floor/plating,
/area/shuttle/abandoned)
"vl" = (
/obj/machinery/atmospherics/pipe/smart/manifold4w/supply/hidden/layer4,
/obj/structure/tank_holder/oxygen/yellow,
/obj/effect/decal/cleanable/dirt/dust,
/turf/open/floor/plating,
/area/shuttle/abandoned)
"vq" = (
/obj/machinery/atmospherics/pipe/smart/manifold4w/supply/hidden/layer4,
/obj/machinery/light/small/built/directional/west,
/obj/effect/decal/cleanable/dirt/dust,
/obj/effect/mapping_helpers/broken_floor,
/turf/open/floor/plating,
/area/shuttle/abandoned)
"vB" = (
/obj/effect/turf_decal/loading_area/white{
	dir = 8
	},
/obj/effect/mapping_helpers/airlock/cyclelink_helper{
	dir = 8
	},
/obj/effect/turf_decal/stripes{
	dir = 4
	},
/obj/effect/turf_decal/stripes/white/line{
	dir = 4
	},
/obj/machinery/door/airlock/external/ruin,
/obj/effect/decal/cleanable/dirt,
/turf/open/floor/plating,
/area/shuttle/abandoned)
"vJ" = (
/obj/effect/decal/cleanable/dirt/dust,
/turf/open/floor/iron/small,
/area/shuttle/abandoned)
"xl" = (
/obj/effect/decal/cleanable/ants,
/obj/effect/decal/cleanable/dirt/dust,
/turf/open/floor/plating,
/area/shuttle/abandoned)
"yi" = (
/obj/effect/decal/cleanable/greenglow/filled,
/obj/effect/decal/cleanable/molten_object/large{
	pixel_y = 4
	},
/obj/effect/decal/cleanable/dirt/dust,
/turf/open/floor/plating,
/area/shuttle/abandoned)
"yu" = (
/mob/living/basic/ant{
	faction = list("spiders")
	},
/obj/effect/decal/cleanable/dirt/dust,
/obj/effect/mapping_helpers/burnt_floor,
/turf/open/floor/iron/small,
/area/shuttle/abandoned)
"zw" = (
/obj/machinery/power/shuttle_engine/heater,
/obj/structure/window/reinforced/spawner/directional/north,
/obj/effect/decal/cleanable/dirt,
/turf/open/floor/plating/airless,
/area/shuttle/abandoned)
"zY" = (
/turf/template_noop,
/area/template_noop)
"AA" = (
/mob/living/basic/ant{
	faction = list("spiders")
	},
/obj/effect/decal/cleanable/dirt/dust,
/obj/effect/mapping_helpers/burnt_floor,
/turf/open/floor/plating,
/area/shuttle/abandoned)
"AB" = (
/obj/effect/gibspawner/human/bodypartless,
/obj/effect/decal/cleanable/dirt/dust,
/turf/open/floor/plating,
/area/shuttle/abandoned)
"Bu" = (
/obj/structure/cable,
/obj/machinery/atmospherics/pipe/smart/manifold4w/supply/hidden/layer4,
/obj/effect/decal/cleanable/dirt,
/obj/effect/mapping_helpers/broken_floor,
/turf/open/floor/plating,
/area/shuttle/abandoned)
"Bv" = (
/obj/machinery/atmospherics/components/unary/vent_pump/on/layer4{
	dir = 8
	},
/obj/effect/decal/cleanable/dirt,
/turf/open/floor/plating,
/area/shuttle/abandoned)
"Bz" = (
/obj/machinery/atmospherics/pipe/smart/manifold4w/supply/hidden/layer4,
/obj/structure/extinguisher_cabinet/directional/west,
/obj/effect/decal/cleanable/dirt/dust,
/obj/effect/mapping_helpers/burnt_floor,
/turf/open/floor/plating,
/area/shuttle/abandoned)
"Cy" = (
/obj/structure/chair/comfy/shuttle{
	dir = 1
	},
/obj/effect/decal/cleanable/dirt/dust,
/turf/open/floor/iron/dark/small,
/area/shuttle/abandoned)
"CG" = (
/obj/effect/turf_decal/bot_white,
/obj/machinery/computer/monitor,
/obj/effect/decal/cleanable/dirt,
/obj/effect/mapping_helpers/burnt_floor,
/turf/open/floor/plating,
/area/shuttle/abandoned)
"CL" = (
/obj/machinery/atmospherics/pipe/smart/manifold4w/supply/hidden/layer4,
/obj/structure/door_assembly/door_assembly_com,
/obj/effect/decal/cleanable/dirt/dust,
/obj/effect/mapping_helpers/burnt_floor,
/turf/open/floor/iron/dark/small,
/area/shuttle/abandoned)
"DQ" = (
/obj/structure/sign/departments/science/alt/directional/west,
/obj/machinery/atmospherics/pipe/smart/manifold4w/supply/hidden/layer4,
/obj/effect/decal/cleanable/dirt/dust,
/turf/open/floor/iron/small,
/area/shuttle/abandoned)
"Ef" = (
/obj/machinery/atmospherics/pipe/smart/manifold4w/supply/hidden/layer4,
/obj/effect/decal/cleanable/blood/splatter/over_window{
	pixel_y = -32
	},
/obj/effect/decal/cleanable/dirt/dust,
/obj/effect/mapping_helpers/burnt_floor,
/turf/open/floor/iron/small,
/area/shuttle/abandoned)
"Ey" = (
/obj/item/storage/toolbox/mechanical{
	pixel_x = -2;
	pixel_y = -1
	},
/obj/item/storage/toolbox/electrical{
	pixel_x = 1;
	pixel_y = 6
	},
/obj/item/storage/belt/utility,
/obj/item/clothing/head/utility/welding{
	pixel_x = -2;
	pixel_y = 1
	},
/obj/structure/closet/crate/engineering,
/obj/effect/decal/cleanable/dirt/dust,
/turf/open/floor/plating,
/area/shuttle/abandoned)
"ED" = (
/obj/machinery/atmospherics/pipe/smart/manifold4w/supply/hidden/layer4,
/obj/effect/decal/cleanable/dirt/dust,
/turf/open/floor/plating,
/area/shuttle/abandoned)
"EN" = (
/obj/structure/closet,
/obj/effect/spawner/random/maintenance/three,
/obj/effect/spawner/random/medical/minor_healing,
/obj/effect/decal/cleanable/dirt/dust,
/turf/open/floor/plating,
/area/shuttle/abandoned)
"Fw" = (
/obj/effect/spawner/structure/window/reinforced/shuttle,
/obj/machinery/door/poddoor{
	id = "whiteship_bridge"
	},
/turf/open/floor/plating,
/area/shuttle/abandoned)
"Fy" = (
/obj/machinery/door/airlock/engineering{
	name = "Engineering"
	},
/obj/machinery/atmospherics/pipe/smart/manifold4w/supply/hidden/layer4,
/turf/open/floor/plating,
/area/shuttle/abandoned)
"FR" = (
/obj/machinery/atmospherics/components/unary/vent_pump/on/layer4{
	dir = 8
	},
/obj/effect/decal/cleanable/dirt/dust,
/obj/effect/mapping_helpers/burnt_floor,
/turf/open/floor/iron/small,
/area/shuttle/abandoned)
"GN" = (
/obj/effect/turf_decal/bot_white,
/obj/machinery/portable_atmospherics/canister/oxygen,
/obj/machinery/atmospherics/components/unary/portables_connector/visible/layer4,
/obj/effect/decal/cleanable/cobweb,
/obj/machinery/airalarm/directional/north,
/obj/effect/mapping_helpers/airalarm/all_access,
/obj/effect/decal/cleanable/dirt,
/turf/open/floor/plating,
/area/shuttle/abandoned)
"Il" = (
/obj/machinery/atmospherics/components/unary/vent_pump/on/layer4,
/obj/effect/decal/cleanable/dirt,
/obj/effect/mapping_helpers/burnt_floor,
/turf/open/floor/plating,
/area/shuttle/abandoned)
"IL" = (
/obj/machinery/light/small/broken/directional/east,
/obj/machinery/power/smes/ship,
/obj/effect/turf_decal/bot_white,
/obj/structure/cable,
/obj/effect/decal/cleanable/dirt,
/turf/open/floor/plating,
/area/shuttle/abandoned)
"Je" = (
/obj/effect/turf_decal/bot_white,
/obj/machinery/power/port_gen/pacman{
	anchored = 1
	},
/obj/item/wrench,
/obj/structure/cable,
/obj/effect/decal/cleanable/dirt,
/turf/open/floor/plating,
/area/shuttle/abandoned)
"JF" = (
/obj/structure/closet,
/obj/item/radio/off{
	pixel_x = 4;
	pixel_y = -6
	},
/obj/item/shovel,
/obj/item/mining_scanner,
/obj/item/pickaxe,
/obj/effect/decal/cleanable/dirt/dust,
/turf/open/floor/iron/small,
/area/shuttle/abandoned)
"JI" = (
/obj/structure/sign/warning/vacuum/external/directional/west,
/obj/machinery/suit_storage_unit/standard_unit,
/obj/machinery/light/small/built/directional/north,
/obj/effect/turf_decal/delivery/white,
/obj/effect/decal/cleanable/dirt,
/obj/effect/mapping_helpers/burnt_floor,
/turf/open/floor/plating,
/area/shuttle/abandoned)
"Kf" = (
/obj/machinery/atmospherics/pipe/smart/manifold4w/supply/hidden/layer4,
/obj/item/plate_shard{
	pixel_y = -4
	},
/obj/effect/decal/cleanable/dirt/dust,
/obj/effect/mapping_helpers/broken_floor,
/turf/open/floor/plating,
/area/shuttle/abandoned)
"Ky" = (
/obj/effect/turf_decal/bot_white,
/obj/machinery/modular_computer/preset/research{
	dir = 1
	},
/obj/effect/decal/cleanable/dirt/dust,
/turf/open/floor/iron/white/small,
/area/shuttle/abandoned)
"Lf" = (
/obj/machinery/computer/shuttle/white_ship/bridge,
/obj/effect/decal/cleanable/dirt/dust,
/turf/open/floor/iron/dark/small,
/area/shuttle/abandoned)
"Lg" = (
/obj/structure/sign/warning/vacuum/external/directional/east,
/obj/machinery/suit_storage_unit/standard_unit,
/obj/effect/turf_decal/delivery/white,
/obj/machinery/light/small/broken/directional/north,
/obj/effect/decal/cleanable/dirt,
/turf/open/floor/plating,
/area/shuttle/abandoned)
"MM" = (
/obj/machinery/atmospherics/pipe/smart/manifold4w/supply/hidden/layer4,
/obj/effect/decal/cleanable/dirt/dust,
/obj/effect/mapping_helpers/burnt_floor,
/turf/open/floor/iron/white/small,
/area/shuttle/abandoned)
"MS" = (
/obj/machinery/atmospherics/components/unary/vent_pump/on/layer4{
	dir = 4
	},
/obj/structure/chair/office{
	dir = 8
	},
/obj/effect/decal/cleanable/dirt/dust,
/obj/effect/mapping_helpers/burnt_floor,
/turf/open/floor/iron/dark/small,
/area/shuttle/abandoned)
"Np" = (
/obj/effect/decal/cleanable/plastic,
/obj/effect/decal/cleanable/dirt/dust,
/obj/effect/mapping_helpers/burnt_floor,
/mob/living/basic/ant{
	faction = list("spiders")
	},
/turf/open/floor/plating,
/area/shuttle/abandoned)
"Nr" = (
/obj/machinery/atmospherics/pipe/smart/manifold4w/supply/hidden/layer4,
/obj/effect/decal/cleanable/dirt/dust,
/mob/living/basic/ant{
	faction = list("spiders")
	},
/turf/open/floor/plating,
/area/shuttle/abandoned)
"Ny" = (
/obj/structure/rack,
/obj/item/clothing/gloves/latex,
/obj/item/clothing/glasses/science,
/obj/effect/decal/cleanable/dirt/dust,
/obj/item/reagent_containers/spray/cleaner,
/turf/open/floor/plating,
/area/shuttle/abandoned)
"NA" = (
/obj/effect/turf_decal/bot_white,
/obj/machinery/space_heater,
/obj/machinery/power/apc/auto_name/directional/west,
/obj/structure/cable,
/obj/effect/decal/cleanable/dirt,
/turf/open/floor/plating,
/area/shuttle/abandoned)
"NB" = (
/obj/machinery/atmospherics/pipe/smart/manifold4w/supply/hidden/layer4,
/obj/machinery/door/airlock/research/glass{
	name = "Research Lab"
	},
/obj/effect/mapping_helpers/airlock/abandoned,
/obj/effect/decal/cleanable/dirt/dust,
/turf/open/floor/plating,
/area/shuttle/abandoned)
"NI" = (
/obj/machinery/atmospherics/pipe/smart/manifold4w/supply/hidden/layer4,
/obj/effect/decal/cleanable/dirt/dust,
/obj/effect/mapping_helpers/burnt_floor,
/turf/open/floor/plating,
/area/shuttle/abandoned)
"NW" = (
/obj/machinery/atmospherics/pipe/smart/manifold4w/supply/hidden/layer4,
/obj/effect/decal/cleanable/ants/fire,
/obj/effect/decal/cleanable/dirt/dust,
/turf/open/floor/iron/small,
/area/shuttle/abandoned)
"Oc" = (
/obj/effect/decal/cleanable/shreds,
/obj/effect/decal/cleanable/dirt/dust,
/turf/open/floor/plating,
/area/shuttle/abandoned)
"Pu" = (
/obj/machinery/light/small/built/directional/west,
/obj/item/rack_parts,
/obj/effect/decal/cleanable/dirt/dust,
/obj/effect/mapping_helpers/burnt_floor,
/turf/open/floor/iron/white/small,
/area/shuttle/abandoned)
"Qp" = (
/obj/structure/closet/emcloset/anchored,
/obj/effect/turf_decal/delivery/white,
/obj/effect/decal/cleanable/dirt,
/obj/effect/mapping_helpers/burnt_floor,
/turf/open/floor/plating,
/area/shuttle/abandoned)
"Ra" = (
/obj/effect/decal/cleanable/dirt/dust,
/obj/structure/reagent_dispensers/watertank/high,
/turf/open/floor/iron/small,
/area/shuttle/abandoned)
"Rm" = (
/obj/structure/closet,
/obj/item/stack/tile/iron/small{
	amount = 60
	},
/obj/item/stack/tile/iron/dark/small{
	amount = 60
	},
/obj/item/stack/tile/iron/white/small{
	amount = 60
	},
/obj/effect/decal/cleanable/dirt/dust,
/obj/item/storage/box/lights/mixed,
/obj/item/lightreplacer,
/turf/open/floor/iron/small,
/area/shuttle/abandoned)
"Rr" = (
/obj/structure/sign/poster/random/directional/north,
/obj/effect/decal/cleanable/dirt/dust,
/obj/effect/mapping_helpers/burnt_floor,
/turf/open/floor/plating,
/area/shuttle/abandoned)
"RJ" = (
/obj/effect/decal/cleanable/dirt/dust,
/obj/effect/mapping_helpers/burnt_floor,
/turf/open/floor/plating,
/area/shuttle/abandoned)
"RZ" = (
/obj/effect/decal/cleanable/insectguts,
/obj/effect/decal/cleanable/dirt/dust,
/turf/open/floor/plating,
/area/shuttle/abandoned)
"Sc" = (
/turf/closed/wall/mineral/titanium/nodiagonal,
/area/shuttle/abandoned)
"Ts" = (
/obj/effect/decal/cleanable/glass,
/obj/item/reagent_containers/cup/bucket{
	pixel_x = 4;
	pixel_y = -6
	},
/obj/effect/decal/cleanable/dirt/dust,
/obj/effect/mapping_helpers/burnt_floor,
/turf/open/floor/plating,
/area/shuttle/abandoned)
"Tt" = (
/obj/machinery/atmospherics/pipe/smart/manifold4w/supply/hidden/layer4,
/obj/machinery/door/airlock/research{
	name = "Research Lab"
	},
/obj/effect/decal/cleanable/dirt/dust,
/turf/open/floor/iron/white/small,
/area/shuttle/abandoned)
"Ud" = (
/obj/effect/turf_decal/loading_area/white{
	dir = 4
	},
/obj/docking_port/mobile{
	dir = 4;
	shuttle_id = "whiteship";
	launch_status = 0;
	name = "White Ship";
	port_direction = 4
	},
/obj/effect/turf_decal/stripes{
	dir = 8
	},
/obj/effect/turf_decal/stripes/white/line{
	dir = 8
	},
/obj/machinery/door/airlock/external/ruin,
/obj/effect/decal/cleanable/dirt,
/obj/effect/mapping_helpers/airlock/cyclelink_helper_multi{
	cycle_id = "whiteship"
	},
/turf/open/floor/plating,
/area/shuttle/abandoned)
"UC" = (
/obj/effect/decal/cleanable/dirt/dust,
/obj/effect/mapping_helpers/broken_floor,
/turf/open/floor/plating,
/area/shuttle/abandoned)
"UM" = (
/obj/machinery/light/small/broken/directional/east,
/obj/machinery/atmospherics/pipe/smart/manifold4w/supply/hidden/layer4,
/obj/effect/decal/cleanable/dirt/dust,
/obj/effect/mapping_helpers/burnt_floor,
/turf/open/floor/plating,
/area/shuttle/abandoned)
"UX" = (
/obj/machinery/power/shuttle_engine/propulsion,
/obj/effect/decal/cleanable/dirt,
/turf/open/floor/plating/airless,
/area/shuttle/abandoned)
"UY" = (
/obj/structure/cable,
/obj/structure/frame/machine,
/obj/item/stack/cable_coil/five,
/obj/effect/decal/cleanable/dirt/dust,
/turf/open/floor/iron/white/small,
/area/shuttle/abandoned)
"Ve" = (
/obj/effect/decal/cleanable/dirt/dust,
/obj/effect/mapping_helpers/burnt_floor,
/turf/open/floor/iron/small,
/area/shuttle/abandoned)
"XZ" = (
/obj/structure/mop_bucket,
/obj/item/soap/nanotrasen,
/obj/item/mop,
/obj/effect/decal/cleanable/dirt/dust,
/obj/effect/mapping_helpers/burnt_floor,
/obj/item/pushbroom,
/turf/open/floor/iron/small,
/area/shuttle/abandoned)
"YP" = (
/obj/machinery/light/small/directional/west,
/obj/machinery/holopad/secure,
/obj/effect/decal/cleanable/dirt/dust,
/obj/effect/mapping_helpers/burnt_floor,
/turf/open/floor/plating,
/area/shuttle/abandoned)
"Zp" = (
/obj/structure/cable,
/obj/machinery/atmospherics/components/unary/vent_pump/on/layer4,
/obj/effect/decal/cleanable/dirt/dust,
/obj/effect/mapping_helpers/broken_floor,
/turf/open/floor/plating,
/area/shuttle/abandoned)
"ZP" = (
/obj/structure/table,
/obj/item/camera{
	pixel_x = 9;
	pixel_y = 6
	},
/obj/item/paper_bin{
	pixel_x = -4
	},
/obj/item/pen{
	pixel_x = -4
	},
/obj/machinery/light/small/built/directional/west,
/obj/effect/decal/cleanable/dirt/dust,
/turf/open/floor/plating,
/area/shuttle/abandoned)
"ZT" = (
/obj/effect/decal/cleanable/dirt/dust,
/turf/open/floor/plating,
/area/shuttle/abandoned)

(1,1,1) = {"
zY
zY
zY
zY
zY
zY
zY
zY
Sc
jT
Ud
jT
Sc
zY
zY
zY
zY
zY
"}
(2,1,1) = {"
zY
zY
zY
zY
zY
zY
jT
jT
jT
JI
sx
bH
jT
jT
jT
zY
zY
zY
"}
(3,1,1) = {"
zY
zY
zY
zY
zY
jT
jT
Ra
Sc
jT
pN
jT
Sc
oT
jT
jT
zY
zY
"}
(4,1,1) = {"
zY
zY
zY
zY
jT
jT
uO
Ve
aq
oY
mm
Bz
vq
cx
vl
jT
jT
zY
"}
(5,1,1) = {"
zY
zY
jT
Sc
jT
EN
vJ
ZT
Sc
Sc
Fy
Sc
Sc
RJ
cx
Ey
jT
Sc
"}
(6,1,1) = {"
zY
jT
jT
ZP
jT
rl
yu
Sc
Sc
GN
bP
NA
Sc
Sc
ED
xl
zw
UX
"}
(7,1,1) = {"
jT
Sc
oI
MS
jT
Rm
ah
Sc
CG
Il
pV
Bu
cE
Sc
ED
cx
zw
UX
"}
(8,1,1) = {"
sl
fr
rV
NI
jT
Ts
eU
Sc
Je
na
sW
IL
Sc
Sc
gQ
Kf
Sc
Sc
"}
(9,1,1) = {"
Fw
Lf
Cy
cS
CL
mm
sy
Sc
Sc
Sc
NB
Sc
Sc
ap
Oc
cx
gN
Sc
"}
(10,1,1) = {"
Fw
lV
Np
nQ
jT
RZ
Ef
Sc
qS
YP
Nr
Pu
Sc
Sc
hV
FR
Sc
Sc
"}
(11,1,1) = {"
jT
Sc
lS
eI
jT
ef
NW
Sc
re
Zp
MM
pk
Ky
Sc
Rr
vJ
zw
UX
"}
(12,1,1) = {"
zY
jT
jT
kZ
jT
Ny
ED
Sc
Sc
UY
km
lO
Sc
Sc
UC
AA
zw
UX
"}
(13,1,1) = {"
zY
zY
jT
Sc
jT
XZ
cx
cS
Sc
Sc
Tt
Sc
Sc
RJ
Ve
hP
jT
Sc
"}
(14,1,1) = {"
zY
zY
zY
zY
jT
jT
yi
cx
UM
DQ
cx
UC
pq
xl
AB
jT
jT
zY
"}
(15,1,1) = {"
zY
zY
zY
zY
zY
jT
jT
JF
Sc
jT
hM
jT
Sc
sY
jT
jT
zY
zY
"}
(16,1,1) = {"
zY
zY
zY
zY
zY
zY
jT
jT
jT
Lg
Bv
Qp
jT
jT
jT
zY
zY
zY
"}
(17,1,1) = {"
zY
zY
zY
zY
zY
zY
zY
zY
Sc
jT
vB
jT
Sc
zY
zY
zY
zY
zY
"}
